Level5

Leveldat:
1,1,1,1,1,1,1,1,1,1,1,1,1,1,1,1,1,1,1,1,1,1,1,1,1,1,1,
2,0,0,0,0,0,0,0,0,0,0,0,0,0,0,0,0,0,0,0,0,0,0,0,0,0,2,
2,0,0,0,0,0,0,0,0,0,0,0,0,0,0,0,0,0,0,0,0,0,0,0,0,0,2,
2,0,0,0,0,0,0,0,0,0,0,0,0,0,0,0,0,0,0,0,0,0,0,0,0,0,2,
2,0,0,0,0,0,0,0,0,0,0,0,0,0,0,0,0,0,0,0,0,0,0,0,0,0,2,
2,0,0,0,0,0,0,0,0,0,0,0,0,0,0,0,0,0,0,0,0,0,0,0,0,0,2,
2,0,0,0,0,0,0,0,0,0,0,0,0,0,0,0,0,0,0,0,0,0,0,0,0,0,2,
2,0,0,0,0,0,0,0,0,0,0,0,0,0,0,0,0,0,0,0,0,0,0,0,0,0,2,
2,0,0,3,3,3,3,3,3,3,3,3,3,3,3,3,3,3,3,3,3,3,3,3,0,0,2,
2,0,0,0,0,0,0,0,0,0,0,0,0,0,0,0,0,0,0,0,0,0,0,0,0,0,2,
2,0,0,0,0,0,0,0,0,0,0,0,0,0,0,0,0,0,0,0,0,0,0,0,0,0,2,
2,0,0,0,0,0,0,0,0,0,0,0,0,0,0,0,0,0,0,0,0,0,0,0,0,0,2,
2,0,0,0,0,0,0,0,0,0,0,0,3,3,3,0,0,3,3,0,0,0,0,0,0,0,2,
2,0,0,0,0,0,0,0,0,0,0,3,3,3,0,0,0,0,3,3,0,0,0,0,0,0,2,
2,0,0,0,0,0,0,0,0,0,3,3,3,0,0,0,0,0,0,3,0,0,0,0,0,0,2,
2,0,0,0,0,0,0,0,0,3,3,3,3,0,0,0,0,0,0,3,3,0,0,0,0,0,2,
2,0,0,0,0,0,0,0,3,3,3,0,3,3,0,0,0,0,0,0,3,0,0,0,0,0,2,
2,0,0,0,0,0,0,0,3,3,0,0,0,3,3,0,0,0,0,0,3,3,0,0,0,0,2,
2,0,0,0,0,0,0,0,0,0,0,0,0,0,3,3,0,0,0,0,0,3,0,0,0,0,2,
2,0,0,0,0,0,0,0,0,0,0,0,0,0,0,3,3,0,0,0,0,3,0,0,0,0,2,
2,0,0,0,0,0,0,0,3,0,0,0,0,0,0,0,3,3,0,0,3,3,0,0,0,0,2,
2,0,0,0,0,0,0,3,3,3,0,0,0,0,0,0,0,3,3,0,3,0,0,0,0,0,2,
2,0,0,0,0,0,3,3,0,3,3,0,0,0,0,0,0,0,3,3,3,0,0,0,0,0,2,
2,0,0,0,0,3,3,0,0,0,3,3,0,0,0,0,0,0,3,3,3,0,0,0,0,0,2,
2,0,0,0,3,3,0,0,0,0,0,3,3,3,0,0,3,3,3,0,3,3,0,0,0,0,2,
2,0,0,3,3,0,0,0,0,0,0,0,0,3,3,3,3,0,0,0,0,3,3,0,0,0,2,
2,0,0,3,0,0,0,0,0,0,0,0,0,0,0,0,0,0,0,0,0,0,3,0,0,0,2,
2,0,0,0,0,0,0,0,0,0,0,0,0,0,0,0,0,0,0,0,0,0,0,0,0,0,2,
2,0,0,0,0,0,0,0,0,0,0,0,0,0,0,0,0,0,0,0,0,0,0,0,0,0,2,
3,3,3,3,3,3,3,3,3,3,3,3,3,3,3,3,3,3,3,3,3,3,3,3,3,3,3,
end


Enemies:
0,6,1,
0,9,1,
0,15,1,
1,20,1,
end

Fruit:
0,10,1,
0,12,1,
end

Powerups:
0,2,2,
0,24,2,
end	